7 7
6 1
2 6
*******
*.....*
***.*..
*.*.*.*
*...***
*.*...*
*.*****